###################
#oooooooo#oooooooo#
#o##o###o#o###o##o#
#0##o###o#o###o##0#
#ooooooooooooooooo#
#o##o#o#####o#o##o#
#oooo#ooo#ooo#oooo#
####o###-#-###o####
---#o#-------#o#---
####o#-##-##-#o####
----o--#---#--o----
####o#-#####-#o####
---#o#-------#o#---
####o#-#####-#o####
#oooooooo#oooooooo#
#o##o###o#o###o##o#
#0o#ooooo-ooooo#o0#
##o#o#o#####o#o#o##
#oooo#ooo#ooo#oooo#
#o######o#o######o#
#ooooooooooooooooo#
###################